NO assets/Brick.xpm
SO assets/Stone.xpm
WE assets/Tiles.xpm
EA assets/Wood.xpm

F 220,100,0
C 225,30,255

11111111111111111111111111
10000000001100000000000001
10110000011100000000000001
100100000000000000000000111111111                
11111111101100001110000000000001           
100000000011000001110111111111111
11110111111111011100000010001
11110111111111011101010010001
11000000110101011100000010001
10000000000000001100000010001
1000000000000000110101001000111
11000001110101011111011110S00011
11110111 1110101 10111101000111
11111111 1111111 111111111111


