NO assets/Brick.xpm
SO assets/Stone.xpm
WE assets/Tiles.xpm
EA assets/Wood.xpm

F 220,100,0
C 225,30,255

111111111111111111111111111111111
100000000000000000000000000001111
110111111111111111111111111111111
100000000000000000000000000000001
10E010000000000000000000000000001
100000000000000000000000000000001
100000000000000000000000000000001
100000011111111111111110000000001
100000000000001000000000000000001
100000000000001000000000000000001
1000000000000010000000001111111111
1000000000000010000000001000000001
1000000000000010000000001111111111
111111111111111111100111111111111
                  1001
                  1111